# # # # S #
# . . . . #
# # . # # #
# . . . . F
# # # . # #
# # # # # #