# # # # # #
# . . . . S
# # . # # #
# . . . . F
# # # . # #
# # # # # #